1111111111111111111111111111
1CCCCCCCCCCCC11CCCCCCCCCCCC1
1C1111C11111C11C11111C1111C1
1X1111C11111C11C11111C1111X1
1C1111C11111C11C11111C1111C1
1CCCCCCCCCCCCCCCCCCCCCCCCCC1
1C1111C11C11111111C11C1111C1
1C1111C11C11111111C11C1111C1
1CCCCCC11CCCC11CCCC11CCCCCC1
111111C11111011011111C111111
111111C11111Z11Z11111C111111
111111C11000000000011C111111
111111C110NNNDDNNN011C111111
111111C110NNNNNNNN011C111111
SSSSSSC000NNNNNNNN000CSSSSSS
111111C110NNNNNNNN011C111111
111111C110NNNNNNNN011C111111
111111C11000000000011C111111
111111C11011111111011C111111
111111C11011111111011C111111
1CCCCCCCCCCCC11CCCCCCCCCCCC1
1C1111C11111C11C11111C1111C1
1C1111C11111z11z11111C1111C1
1XCC11CCCCCCCP0CCCCCCC11CCX1
111C11C11C11111111C11C11C111
111C11C11C11111111C11C11C111
1CCCCCC11CCCC11CCCC11CCCCCC1
1C1111111111C11C1111111111C1
1C1111111111C11C1111111111C1
1CCCCCCCCCCCCCCCCCCCCCCCCCC1
1111111111111111111111111111
