1111111111111111111111111111111111
1CCCCCCCCCCCCCCCCCCCCCCCCCCCCCCCC1
1CWWWC11111111111C11111111111111C1
1CWWWC11111111111C11111111111111C1
1CWWWCCCCCCCCCCCCCCCCCCCCCCCCCCCC1
1CWWWWWWWCWWWWWWWCWWWWWWCWWWWWWWC1
1CWWWWWWWCWWWWWWWCWWWWWWCWWWWWWWC1
1CWWW0WWWCWWW0WWWCWWWCCCCWWWCWWWC1
1XWWWWWWWCWWWWWWWCWWWC11CWWWCWWWX1
1CWWWWWWWCWWWWWWWCWWWC11CWWWCWWWC1
1CCCCCCCCCCCCCCCCCCCCC11CCCCCCCCC1
1C1111111C11CWWWWWWWWC11C1111111C1
1C1111111C11CWWWWWWWWC11C1111111C1
1CCCCCCCCC11CCCCWWCCCC11CCCCCCCCC1
111111111C11111CWWC11111C111111111
111111111C11111ZWWZ11111C111111111
111111111C11000000000011C111111111
111111111C110NNNDDNNN011C111111111
111111111C110NNNNNNNN011C111111111
SSSSSSSSSC000NNNNNNNN000CSSSSSSSSS
111111111C110NNNNNNNN011C111111111
111111111C110NNNNNNNN011C111111111
111111111C11000000000011C111111111
111111111C11011111111011C111111111
111111111C11011111111011C111111111
1CCCCCCCCCCCCCCCC111CCCCCCCCCCCCC1
1C1111111C111111C111CWWWCWWWWWWWC1
1C1111111C111111C111CWWWCWWWWWWWC1
1XCCCCCCCCCCPCCCCCCCCWWWCWWW0WWWX1
1CWWWWWWCWWWWWWWCWWWWWWWCWWWWWWWC1
1CWWWWWWCWWWWWWWCWWWWWWWCWWWWWWWC1
1CWWWCCCCWWW0WWWCWWW0WWWCWWWCCCCC1
1CWWWWWWCWWWWWWWCWWWWWWWCWWWWWWWC1
1CWWWWWWCWWWWWWWCWWWWWWWCWWWWWWWC1
1CCCCCCCCCCCCCCCCCCCCCCCCCCCCCCCC1
1111111111111111111111111111111111
