1111111111111111111111111111
1CCCCCCCCCCCC11CCCCCCCCCCCC1
1CWWWWCWWWWWC11CWWWWWCWWWWC1
1X1111C11111C11C11111C1111X1
1C1111C11111C11C11111C1111C1
1CCCCCCCCCCCCCCCCCCCCCCCCCC1
1CWWWWCWWCWWWWWWWWCWWCWWWWC1
1C1111C1WC11111111C1WC1111C1
1CCCCCC1WCCCC11CCCC11CCCCCC1
111111C1WWWW0110WWW11C111111
111111C11111Z11Z11111C111111
111111C11000000000011C111111
111111C110NNNDDNNN011C111111
111111C110NNNNNNNN011C111111
SSSSSSC000NNNNNNNN000CSSSSSS
111111CWW0NNNNNNNN0WWC111111
111111C1W0NNNNNNNN01WC111111
111111C11000000000011C111111
111111C110WWWWWWWW011C111111
111111C11011111111011C111111
1CCCCCCCCCCCC11CCCCCCCCCCCC1
1CWWWWCWWWWWC11CWWWWWCWWWWC1
1C1111C11111z11z11111C1111C1
1XCC11CCCCCCCP0CCCCCCC11CCX1
1WWC11CWWCWWWWWWWWCWWC11CWW1
111C11C1WC11111111C1WC11C111
1CCCCCC1WCCCC11CCCC1WCCCCCC1
1CWWWWW1WWWWC11CWWW1WWWWWWC1
1C1111111111C11C1111111111C1
1CCCCCCCCCCCCCCCCCCCCCCCCCC1
1111111111111111111111111111
