111111111111111111111111111111111111111111
1CCCCCCCCCCCCCCCCCCCCCCCCCCCCCCCCCCCCCCCC1
1CCCCCCCCCCC0WWWWWWW111111111C1111111111C1
1CCCCCCCCC0CCWWWWWWW111111111C1111111111C1
1CCCCCCCCC0CCWWWCWWWCCCCCCCCCCCCCCCCCCCCC1
1CWWWWWWWWWWCWWWWWWWCWWWW0000C0000000000C1
1CWWWWWWWWWWCWWWWWWWCWWWW0000C0000000000C1
1CWWWCWWCWWW0WWW00CCCWWW00000C000CC0C000C1
1XWWWXWWXWWWCWWWWWWW0WWW00000C000C10C000X1
1CWWWCWWCWWWCWWWWWWW0WWW00000C000C10C000C1
1CCCCCCCCCCCCCCCCCCCCCCCCCCCCC11CCCCCCCCC1
1CCCCCCCCC1111111C11CWWWWWWWWC11C1111111C1
1CCCCCCCCC1111111C11CWWWWWWWWC11C1111111C1
1CCCCCCCCCCCCCCCCC11CCCCWWCCCC11CCCCCCCCC1
11111111111111111C11111CWWC11111C111111111
11111111111111111C11111ZWWZ11111C111111111
11111111111111111C11000000000011C111111111
11111111111111111C110NNNDDNNN011C111111111
11111111111111111C110NNNNNNNN011C111111111
SSSSSSSSSSSSSSSSSC000NNNNNNNN000CSSSSSSSSS
11111111111111111C110NNNNNNNN011C111111111
11111111111111111C110NNNNNNNN011C111111111
11111111111111111C11000000000011C111111111
11111111111111111C11011111111011C111111111
11111111111111111C11011111111011C111111111
1CCCCCCCCCCCCCCCCCCCCCCCC111CCCCCCCCCCCCC1
1CCCCCCCCC1111111C111111C111CWWWCWWWWWWWC1
1CCCCCCCCC1111111C111111C111CWWWCWWWWWWWC1
1XXXXXXXXXCCCCCCCCCCPCCCCCCCCWWWCWWW0WWWX1
1CCCCCCCCCWWWWWWCWWWWWWWCWWWWWWWCWWWWWWWC1
1CCCCCCCCCWWWWWWCWWWWWWWCWWWWWWWCWWWWWWWC1
1CCCCCCCCCWWWCCCCWWW0WWWCWWW0WWWCWWWCCCCC1
1CCCCCCCCCWWWWWWCWWWWWWWCWWWWWWWCWWWWWWWC1
1CCCCCCCCCWWWWWWCWWWWWWWCWWWWWWWCWWWWWWWC1
1CCCCCCCCCCCCCCCCCCCCCCCCCCCCCCCCCCCCCCCC1
111111111111111111111111111111111111111111
