1111111111111111111111111111
1CCCCCCCCCCCCC00CCCCCCCCCCC1
1C111011111111C11111111111C1
1C111011111111C11111111111C1
1C11100CC00000C00C00000000C1
1C111111C11111C11111011111C1
1C111111C11111C11111011111C1
1C111011C11011C11C00011011C1
1X111111C11111C11C11011011X1
1C111111C11111C11C11011011C1
1CCCCCCCCCCCCCCCCCCCCCCCCCC1
1C1111C11C11111111C11C1111C1
1C1111C11C11111111C11C1111C1
1CCCCCC11CCCC11CCCC11CCCCCC1
111111C11111011011111C111111
111111C11111Z11Z11111C111111
111111C11000000000011C111111
111111C110NNNDDNNN011C111111
111111C110NNNNNNNN011C111111
SSSSSSC000NNNNNNNN000CSSSSSS
111111C110NNNNNNNN011C111111
111111C110NNNNNNNN011C111111
111111C11000000000011C111111
111111C11011111111011C111111
111111C11011111111011C111111
1CCCCCCCCCCCC1111CCCCCCCCCC1
1C1111C11111C1111011011111C1
1C1111C11111z1111011011111C1
1XCC00CCCCCCCP0CCC11C11011X1
1011111101111101111101111101
1011111101111101111101111101
1C11CCC0011011011C11011CCCC1
1C111111011111011111011111C1
1C111111011111011111011111C1
1CCCCCCCCCCCCCCCCCCCCCCCCCC1
1111111111111111111111111111
