11111111111111111111111111111111111111111111111111
1C000000000000000000000000000000000000000000000001
1C111011101111110000011100000000000000000000000001
1X111011101111110000011100000000000000000000000001
1C111011100001110000000000000000000000000001110001
1C111111101111110000011101110111000111110111111101
1C111111101111110000011101110111000111110111111101
1C000011101110000111011101110111000111000001110001
1C111011101111110111111101111111011111000001111001
10111011101111110111111101111111011111000001111001
10C00000000000000000000000000000000000000000000001
10C00000000000001111111111100000000000000000000001
10C00000000000001111111111100000000001100000000001
10C00000000000000000111000000000000001100000000001
111111101111100000001110NNNDDNNN011111111111011111
111111101111100000001110NNNNNNNN011111111111011111
111111100000000000001110NNNNNNNN000000000000011111
SSC000001111111100001110NNNNNNNN0111000111110SS0SS
111111101111111100001110NNNNNNNN011100011111011111
11111110111000000000000000000000011100011100011111
11111110111011111111111111110111111101111100011111
10C00000111011111111111111110111111101111100000001
1CC00000000000000000000000000000000000000000000001
1CC0000000000P000000001110111000000000000000000001
1CC00000000000000000001110111000000000000000000001
1CC00000000000000000001110111000000000000000000001
1CC00000000000000000001110000000000000000000000001
1C111111101111111011111110111011111110111111100001
1C111111101111111011111110111011111110111111100001
1C111000001110111011101110111011101110111011100001
1C111111101111111011111110111011101110111111100001
1C111111101111111011111110111011101110111111100001
1CC00000000000000000000000000000000000000011100001
1CC00000000000000000000000000000000000111111100001
1CC00000000000000000000000000000000000111111100001
1CC00000000000000000000000000000000000000000000001
11111111111111111111111111111111111111111111111111
