1111111111111111111111111111111111111111111111111
1C00000000000000000000000000000000000000000000001
1C11101110111111011101111111111101111111111111101
1X11101110111111011101111111111101111111111111101
1C11101110000111011100000000000000000000000000001
1C11111110111111011111110111111101111110111111101
1C11111110111111011111110111111101111110111111101
1C00001110111000011101110111011101110000111011101
1C11101110111111011111110111111101110110111011101
1011101110111111011111110111111101110110111011101
10C0000000000000000000000000000000000110000000001
10C0000000000000111111111110000000000110000000001
10C0000000000000111111111110000000000110000000001
10C0000000000000000011100000000000000110000000001
111111101111100000001110NNNDDNNN01111111111101111
111111101111100000001110NNNNNNNN01111111111101111
111111100000000000001110NNNNNNNN00000000000001111
SSC000001111111100001110NNNNNNNN0111011111110SSSS
111111101111111100001110NNNNNNNN01110111111101111
1111111011100000000000000000000001110111011101111
1111111011101111111111111111011111110111111101111
10C0000011101111111111111111011111110111111100001
1011111011100000000000000P00011101110111000001101
1C11111011111111011111111111011111110111111101101
1C11111011111111011111111111011111110111111101101
1CC0000000000000011100000111000000000000000001101
1111101111111011011111111111011111111110110111101
1111101111111011011111111111011111111110110111101
10C0000011000011000000000000000000110000110000001
1C11111011011111111111011111111110110111111111101
1C11111011011111111111011111111110110111111111101
1CC0000000000000000000000000000000000000000000001
1111111111111111111111111111111111111111111111111
